11 13
#############
#a..........#
#....A.A...a#
#.###.#A#####
#.@......a#+#
#.#########.#
#.#a......#.#
#+#.###A#A#.#
###.........#
#......a....#
#############
