7 12
############
#.........a#
#......A..a#
#...aA@Aa..#
#.....A....#
#.....a....#
############