7 11
###########
#..........
#.....aA...
#...aA@AA..
#.....A....
#.....a....
###########