12 10
.....####.
######.@##
#.A......#
#.#.##.#.#
#.#..#A#.#
#.#A.#.#.#
#.#..#.A.#
#.##.#.###
#..aaaa.#.
####.##.#.
...#....#.
...######.