10 12
############
#########..#
#...#.aaaaa#
#.A.a.#....#
##.####....#
#.....#.####
#...#....A.#
######AAAA.#
######@....#
############